{
  "id": "test",
  "name": "Test Map",
  "cols": 15,
  "rows": 10,
  "tiles": [
    [0, 0, 1, 1, 1, 1, 1, 1, 1, 1, 1, 1, 1, 0, 0],
    [0, 1, 1, 1, 1, 1, 2, 1, 2, 1, 1, 1, 1, 1, 0],
    [0, 1, 3, 1, 1, 1, 1, 1, 1, 1, 1, 1, 4, 1, 0],
    [0, 1, 1, 1, 1, 0, 0, 1, 0, 0, 1, 1, 1, 1, 0],
    [1, 3, 1, 1, 0, 0, 0, 1, 0, 0, 0, 1, 1, 4, 1],
    [1, 1, 1, 1, 0, 0, 0, 1, 0, 0, 0, 1, 1, 1, 1],
    [0, 1, 1, 1, 1, 0, 0, 1, 0, 0, 1, 1, 1, 1, 0],
    [0, 1, 3, 1, 1, 1, 1, 1, 1, 1, 1, 1, 4, 1, 0],
    [0, 1, 1, 1, 1, 1, 2, 1, 2, 1, 1, 1, 1, 1, 0],
    [0, 0, 1, 1, 1, 1, 1, 1, 1, 1, 1, 1, 1, 0, 0]
  ]
}
